11111111111111111111111111111111
100000000000000CC100000000110101
10000000000E11111P000000C0C01011
11111111111111111111111111111111
